"filename", "language", "JavaScript", "comment", "blank", "total"
"d:\D\TUGAS ON GOING\SKRIPSI\program\proyek-skripsi\components\Auth.js", "JavaScript", 0, 0, 1, 1
"d:\D\TUGAS ON GOING\SKRIPSI\program\proyek-skripsi\components\BarChart.js", "JavaScript", 31, 0, 4, 35
"d:\D\TUGAS ON GOING\SKRIPSI\program\proyek-skripsi\components\BorderLinearProgress.js", "JavaScript", 27, 0, 4, 31
"d:\D\TUGAS ON GOING\SKRIPSI\program\proyek-skripsi\components\BottomProgress.js", "JavaScript", 67, 5, 13, 85
"d:\D\TUGAS ON GOING\SKRIPSI\program\proyek-skripsi\components\Drawer.js", "JavaScript", 87, 0, 15, 102
"d:\D\TUGAS ON GOING\SKRIPSI\program\proyek-skripsi\components\Firebase.js", "JavaScript", 30, 6, 7, 43
"d:\D\TUGAS ON GOING\SKRIPSI\program\proyek-skripsi\components\Footer.js", "JavaScript", 48, 0, 9, 57
"d:\D\TUGAS ON GOING\SKRIPSI\program\proyek-skripsi\components\HomeNavbar.js", "JavaScript", 27, 0, 3, 30
"d:\D\TUGAS ON GOING\SKRIPSI\program\proyek-skripsi\components\LearningProgress.js", "JavaScript", 18, 0, 2, 20
"d:\D\TUGAS ON GOING\SKRIPSI\program\proyek-skripsi\components\MainLayout.js", "JavaScript", 33, 0, 6, 39
"d:\D\TUGAS ON GOING\SKRIPSI\program\proyek-skripsi\components\Navbar.js", "JavaScript", 173, 0, 18, 191
"d:\D\TUGAS ON GOING\SKRIPSI\program\proyek-skripsi\components\ProgressCircularBar.js", "JavaScript", 24, 0, 3, 27
"d:\D\TUGAS ON GOING\SKRIPSI\program\proyek-skripsi\components\ProtectedRoutes.js", "JavaScript", 7, 16, 3, 26
"d:\D\TUGAS ON GOING\SKRIPSI\program\proyek-skripsi\components\QuestionBox.js", "JavaScript", 22, 0, 6, 28
"d:\D\TUGAS ON GOING\SKRIPSI\program\proyek-skripsi\components\Sections.js", "JavaScript", 73, 0, 8, 81
"d:\D\TUGAS ON GOING\SKRIPSI\program\proyek-skripsi\components\TableComponent.js", "JavaScript", 9, 0, 4, 13
"d:\D\TUGAS ON GOING\SKRIPSI\program\proyek-skripsi\components\context\AuthContext.js", "JavaScript", 59, 4, 13, 76
"d:\D\TUGAS ON GOING\SKRIPSI\program\proyek-skripsi\components\data\drawerStyles.js", "JavaScript", 37, 1, 1, 39
"d:\D\TUGAS ON GOING\SKRIPSI\program\proyek-skripsi\components\data\drawersData.js", "JavaScript", 82, 0, 1, 83
"d:\D\TUGAS ON GOING\SKRIPSI\program\proyek-skripsi\components\utils\useFireStore.js", "JavaScript", 21, 5, 10, 36
"d:\D\TUGAS ON GOING\SKRIPSI\program\proyek-skripsi\components\utils\userFirestoreSavings.js", "JavaScript", 59, 2, 20, 81
"d:\D\TUGAS ON GOING\SKRIPSI\program\proyek-skripsi\components\utils\userLocalSavings.js", "JavaScript", 23, 3, 2, 28
"Total", "-", 957, 42, 153, 1152